//20
$1
XXXXGXXX
XXGXXXGX
XXXBXXXX
XXGXXXGX
XXXXGXXX

$2
XXXXXXXG
XXGXXXXX
XXXBXXXX
XXGXXXXX
XXXXXXXG

$3
XXXXGXXX
XXXXXXXX
XXBXXXGX
XXXXXXXX
XXXGXXXX

$4
XXXXXXXX
XXGXXXXX
XXXXBXXX
XXGXXXXX
XXXXXXXX